R 1280 720


SO ./textures/east.xpm
NO ./textures/east.xpm

WE ./textures/east.xpm

EA ./textures/east.xpm

S ./textures/barrel.xpm

F 0,0,0

C 225,      35, 170

        1111111111111111111111111
        1000000000110000000000001
        101100000111000011120000011111
        1001000000000001   100000000001
11111111101100000111000011110000011111
100000000011000001110111111111111
111101111111110111000000100000001
111101111111110111010100100000001
110000001101010111000000100000001
1000200000000000110000001002000011111
100000000000000011010100100N0000000001
1100000111010101111101111000000011111
111101111111010101011110100000001
110000000000000000000000000000001
111111111111111111111111111111111
