R 800 600


SO ./textures/sud.xpm
NO ./textures/nord.xpm

WE ./textures/west.xpm

EA ./textures/east.xpm

S ./textures/barrel.xpm

F 70,        100,        25

C 225,      35, 170

        1111111111111111111111111
        1000000000110000000000001
        10110000011100001112000001111
        1001000000000001   10000000001
11111111101100000111000011110000011111
100000000011000001110111111111111
111101111111110111000000100000001
111101111111110111010100100000001
110000001101010111000000100000001
100020000000000011000000100000001
100000000000000011010100100N00001
11000001110101011111011110000000111
111101111111010101011110100000001
110000000000000000000000000000001
111111111111111111111111111111111
