R 800 600

SO ./textures/pikachu.xpm
NO ./textures/pikachu.xpm

WE ./textures/pikachu.xpm

EA ./textures/pikachu.xpm

S ./textures/pikachu.xpm

F 255, 255, 255

C 0, 0, 0

111111111111111111
100000000000000001
1000N0000000000001
100000000000000001
100000000000000001
100000000000000001
100000011111000001
100000011101000001
100000011001000001
100000011100010001
100000011111000001
100000000000000001
100000000000000001
100000000000000001
100000000000000001
111111111111111111
