R 800 600

SO ./textures/pikachu.xpm
NO ./textures/pikachu.xpm

WE ./textures/pikachu.xpm

EA ./textures/pikachu.xpm

S ./textures/pikachu.xpm

F 70,        100,        25

C 225,      35, 170

111111111111111111
100000000000000001
100000000000000001
100000000000000001
100000000000000001
100000000000000001
100000011111000001
100000011101000001
100000011N01000001
100000011100000001
100000011111000001
100000000000000001
100000000000000001
100000000000000001
100000000000000001
111111111111111110
