R 1280 720

SO ./textures/sud.xpm
NO ./textures/nord.xpm

WE ./textures/west.xpm

EA ./textures/east.xpm

S ./textures/barrel.xpm

F 139,69,19

C 135,206,235

        1111111111111111111111111
        1000000000110000000000001
        1011000001110000002000001
        1001000000000000000000001
111111111011000001110000000000001
100000000011000001110111111111111
111101111111110111000000100000001
111101111111110111010100100000001
110000001101010111000000100000001111111
100020000000000011000000109000001
10000000000000001101010010N000001
11000001110101011111011110000000111
111101111111010101011110100000001
111111111111111111111111111111111
