R 1280 720


SO ./textures/wall.xpm
NO ./textures/wall.xpm

WE ./textures/wall.xpm

EA ./textures/wall.xpm

S ./textures/sprite.xpm

F 0, 0, 0

C 225,      35, 170

        1111111111111111111111111
        1000000000110000000000001
        1011000001110001111110000111111
        1001000000000001    100000000001
111111111011000001110001111110000111111
100000000011000001110111111111111
111101111111110111000000100000001
111101111111110111010100100000001
110000001101010111000000100000001
1000200000000000110000001002000011111
100000000000000011010100100N0000000001
1100000111010101111101111000000011111
111101111111010101011110100000001
110000000000000000000000000000001
111111111111111111111111111111111
